0000000000
0111111110
0100010010
0111111110
0100010010
0111111110
0100010010
0100010010
0111111110
0000000000